1111111111111111
PEC0000000000001
1111111111111100
