11111111111111111
1PEC0000000000000
11111111111111111
