111111111111111111110000001
100000000000000000000000001
PEC000000000000000000000001
111111111111111111111111111
