11111111111111111
01111111111111111
1111111111PEC1111
11111111111111111
