11111111111111111111111111
10000000000000000000000011
10000000000000000000000001
111111111110000000000000E1
11C111111111000000000000P1
11111111111111111111111111
