11111111111111111111111111111111111111111111
1EE00000000000000000000000000000000000000001
10000000000000000000000000000000000000000P01
1C000000000000000000000000000000000000000001
11111111111111111111111111111111111111111111
