11111111111111111111111111
10000000000000000000000011
10000000000000000000000001
111111111110000000000000C1
11E111111111000000000000P1
11111111111111111111111111
