1111111111111111111111111111111
1PEC000000000000000000000000001
1111111111111111111111111111111
