11111111111111111111111111111111111111111111111111111111
10000000000000000000000000000000000000000000000000000001
1P000000000000000000000000000000000000000000000000000001
11111111111110CCCCCCCC0000000000000000000000000000000001
1E11111111111000000000000000000000000000000000000000000101
10000000000000111111111111111111111111111111111111111111
11111111111111111111111111111111111111111111111111111111
